#MAP V1.0
name:地图1
money:300
lives:25
size:20
background:@maps/map1.vec
map:
00000000000000000000
00000000000000000000
00000000000000000000
00000000000000000000
00000000000000000000
00001111111111100000
00001000000000100000
00001000000000100000
00001000000000100000
30001000040000100000
00001000000000100000
0000100000000010000
00001000000000100000
00001000000000100000
00001111101111100000
00000000000000000000
00000000000000000000
00000000000000000000
00000000000000000000
00000000000000000000
mapend
wave:
0 10 10
1 5 5
0 5 5
1 5 5
waveend
wpmap:
0 9 9 9
wpmapend