#MAP V1.0
name:地图1
money:300
lives:25
size:20
background:@maps/map1.vec
map:
11111111111111111111
10000000000100001001
13000010000100001001
10000011100101001001
11111110000101101001
11100000110100101001
11000000000110101001
11000011111100141001
11011010000100101001
10000010010100111001
10011110010110001001
10100001010011001001
10001000010010001001
10100000010000001001
11111111111111111111
10001000000000000001
10002112000000000001
10000000000000000001
10000000000000000001
11111111111111111111
mapend
wave:
0 10 10
1 5 5
0 5 5
1 5 5
waveend
wpmap:
1 2 15 7
wpmapend