#MAP V1.0
name:地图1
money:300
lives:25
size:25x20
background:@maps/map0.vec
map:
11111111111111111111
10000000000100000001
10000000000100000001
13000000000100000041
10000000000100000001
10000000000100000001
11111100000100000001
10000000000100000001
10000000000100000001
10000000000100000001
10000000000100000001
10000000000100000001
10000111111100000001
10000000000000000001
10000000000000000001
10000000000000000001
10000000000000000001
10000000000000000001
10000000000000000001
11111111111111111111
mapend
wave:
0 5 10
0 5 10
1 5 10
0 5 10
1 5 10
0 3 10
3 2 2
1 5 10
0 10 10
2 5 10
3 5 10
2 10 10
1 10 10
3 10 10
0 10 10
1 7 10
2 3 1
3 10 10
2 10 10
1 10 10
0 10 10
3 5 10
0 5 0
1 5 10
2 5 0
3 3 10
2 3 0
0 3 0
4 1 0
waveend
wpmap:
1 3 18 3
wpmapend