#MAP V1.0
name:地图1
money:9999999
lives:25
size:20x20
background:@maps/map0.vec
map:
11111111111111111111
10000000000000000001
10000000000000000001
10000000000000000001
10000003000000000001
10000000000000000001
10000000000000000001
10000000000000000001
10000000000000000001
10000000000000000001
10000000000000000001
10000000000000000001
10000000000000000001
10000000000000000001
10000000000000000001
10000000000000000001
10000000000000000001
10000000000000000401
10000000000000000001
11111111111111111111
mapend
wave:
0 500 10
1 3 10
waveend
wpmap:
7 6 17 17
wpmapend